XXXXXXXXXXXXXXXXXOXXXXXXXXXXXXXXXXXXXXXXXXXXXXXXXXXXXXXXXXXXXXXXXXXXXXXXXXXXXXXXXXXXXXXXXXXX
XXP  SS                 XXXX   CCC      XXXX   XXXXX                       XXX             O
XX                      XXXX            XXXX   XXXXX  CC  XXXXXXXXXXX  C   XXX    CCC     XX
XXXXXXXXXXXXCCCCCC      CCCC     XXXX    S     XXXXX   S  XXXXXXXXXXX  C   XXX    CSC  XXXXX
XXXXXXXXXXXXXXXXXX      CCCC     XXXX          CCCCC      XXX          S   XXX    CCC  XXXXX
XX        S   XXXX      XXXX     XXXXXXXXXXXXXXXXXXXXXXXXXXXX     XXXXXXXXXXXX    CCC     XX
XX   CCCCCC   XXXX      XXXX      C            XXXXXXXXXXXXXX     XXXXXXXXXXXX            XX
XX   CCCCCC         S   XXXX   S  C  XXCXX     XXXX        XX     XXXX  C  XXXXXXXXXX     XX
XX            XXXX      XXXX         XXXXX     XXXX  CCCC  XX  S  XXXX  C  XXXXXXXXXX     XX
XXXXXXXXXXXXXXXXXX               XXXXXXXXXXXX  XXXX  CCCC  XX     XXXX     XXX       CC   XX
XXXXXXXXXXXXXXXXXX      CCCC     XXXXXXXXXXXX  XXXX     S  XX              XXX       XX   XX
XX                                CC           S    XXXXXXXXXXXXXXXXXXXXXXXXXX      XXXX  XX
XX CCSCC    XXXXXXXXXXXXXXXXXXXXXXCCXXXXXXXXXXX     XXXXXXXXXXXXXXXXXXXXXXXXXX     XXXXXX XX
XX CCCCC    XXXXXXXXXXXXXXXXXXXXXXCCXXXXXXXXXXX     XXXXXXXXXX  CCSCC  XXX      S         XX
XX          XXX       CCCS   CCCCC S CCC    XXX                        XXX     XXXX  CCC  XX
XXXXXXXXX S XXX    XXXXXCCCXXXXXXX XXXXX    XXX       XXX              XXX     XXXX       XX
XXXXXXXXX   XXX    XXXXXXXXXXXXXXX XXXXX    XXX  SS   XXX     SSS      XXXCCCXXXXXXXXXXXXXXX
XX          XXX    XXX  CC  XXX             XXX  CC   XXX   SS C SS    XXX      CC        XX
XX  XXXXXXCXXXX    XXX  CS  XXX    XXXXXX   XXX       XXX     S S      XXX         XX     XX
XX  XXXXXXCXXXX    XXXX    XXXX    XXXXXX   XXXXXXX   XXX              XXX  XXXX SXXXXXXXXXX
XX       XXXXXX            XXXX    CCCCS    XXXXXXX   XXX    XXXXX     XXX SXXXX  CCCCC   XX
XXXXXX   XXXXXX    XXXX    XXXX S  CXXXX    XXX          XXXXXXXXXXXX  XXX  XXXX  CCCCC   XX
XXXXXX   XXXXXX    XXXX    XXXX    XXXXX    XXX   XXX    XXXX  CC XXX  CCC  XXXX  CCSCC   XX 
XXXXXX          C  XXXX      C     XXXXX    CCC   XXX     CC     SXXX  CCC  XXXX  CCCCC   XX
XXXXXXXXXXXXXXXXXXXXXXXXXXXXXXXXXXXXXXXXXXXXXXXXXXXXXXXXXXXXXXXXXXXXXXXXXXXXXXXXXXXXXXXXXXXX
